10
10
0000000000
0000000000
0000000000
0000000000
0000000000
1111411661
1111bkkfe1
1111111111
1111111111
1111111111
