40
10
0000000000000000000000000000000000000000
0000004000000000000000000000000000000000
0000000000000000000000000000000000000000
0000000000000016117100000110000000000000
000000000315171j11j111111111111100000000
111401117j1bkfke11j111111111111911110000
111j8111be11111110j011110000000bkkkkkk41
011ze1111110000000j000111111000000000000
001111100000000000j000000011111112000000
========================================