20
10
00000000000000000000
00000040000000000000
00000000000000000000
00000000000000161121
000000000315171j1111
111401117j1bkfke1111
111j8111be1111111000
001be111111000000000
00000000000000000000
00000000000000000000