40
10
0000000000000000000000000000000000000000
0000004000000000000000000000000000000000
0000000000000000000000000000000000000000
0000000000000016111111111110000000000000
000000000315171j111111111111111100000000
111401117j1bkfke111111111111199941410000
111j8111be111111100011110000000bfke11111
011ze11111100000000000111111000000000000
0011111000000000000000000011111112000000
0000000000000000000000000000000000000000